64,64,64,64,64,64,64,64,64,64,64,64,64,64,64,64,64,64,64,64,64,64,64,64,64,64,64,64,64,64,64,64,64,64,64,64,64,64,64,64,64,64,64,64,64,64,64,64,64,64,64,64,64,64,64,64,64,64,64,64,64,64,64,64,64,64,64,64,64,64,64,64,64,64,64,64,64,64,64,64,64,64,64,64,64,64,64,64,64,64,64,64,64,64,64,64,64,64,64,64,64,64,64,64,64,64,64,64,64,64,64,64,64,64,64,64,64,64,64,64,64,64,64,64,64,64,64,64,64,64,64,64,64,64,64,64,64,64,64,64,64,64,64,64,64,64,64,64,64,64,64,64,64,64,64,64,64,64,64,64,64,64,64,64,64,64,64,64,64,64,64,64,64,64,64,64,64,64,64,64,64,64,64,64,64,64,64,64,64,64,64,64,64,64,64,64,64,64,64,64
64,64,64,64,64,64,64,64,64,64,64,64,64,64,64,64,64,64,64,64,64,64,64,64,64,64,64,64,64,64,64,64,64,64,64,64,64,64,64,64,64,64,64,64,64,64,64,64,64,64,64,64,64,64,64,64,64,64,64,64,64,64,64,64,64,64,64,64,64,64,64,64,64,64,64,64,64,64,64,64,64,64,64,64,64,64,64,64,64,64,64,64,64,64,64,64,64,64,64,64,64,64,64,64,64,64,64,64,64,64,64,64,64,64,64,64,128,98,98,98,98,64,64,64,64,64,64,64,64,64,64,64,64,64,64,64,64,64,64,64,64,64,64,64,64,64,64,64,64,64,64,64,64,64,64,64,64,64,64,64,64,64,64,64,64,64,64,64,64,64,64,64,64,64,64,64,64,64,64,64,64,64,64,64,64,64,64,64,64,64,64,64,64,64,64,64,64,64,64,64
64,64,64,64,64,64,64,64,64,64,64,64,64,64,64,64,64,64,64,64,64,64,64,64,64,64,64,64,64,64,64,64,64,64,64,64,64,64,64,64,64,64,64,64,64,64,64,64,64,64,64,64,64,64,64,64,64,64,64,64,64,64,64,64,64,64,64,64,64,64,64,97,97,97,98,99,64,64,64,64,64,64,64,64,64,64,64,64,64,64,64,64,64,64,97,98,98,98,98,98,64,64,64,64,64,64,64,64,64,64,64,64,97,98,98,98,102,102,102,102,102,99,64,64,64,64,97,98,98,99,64,64,97,98,98,99,64,64,64,64,64,64,64,64,64,64,64,64,64,64,64,64,64,64,64,97,102,102,102,64,64,64,64,64,64,64,64,64,64,64,64,64,64,64,64,64,64,64,64,64,64,64,64,64,64,64,64,64,64,64,64,64,64,64,64,64,64,64,64,64
64,64,64,64,64,64,64,64,64,64,64,64,64,64,64,64,64,64,64,64,64,64,64,64,64,64,64,64,64,64,64,64,64,64,64,64,64,64,64,64,64,64,64,64,64,64,64,64,64,64,64,64,64,64,64,64,64,64,64,64,64,64,64,64,64,64,64,64,64,64,128,102,102,102,102,102,132,64,64,64,64,64,64,64,64,64,64,64,64,64,64,64,64,128,102,102,102,102,102,102,131,64,64,64,64,64,64,64,64,64,64,128,102,102,102,102,102,102,102,102,102,102,99,64,64,97,102,102,102,102,99,97,102,102,102,131,132,64,64,64,64,64,64,64,64,64,64,64,64,64,64,64,64,64,97,102,102,102,102,102,102,64,64,64,64,64,64,64,64,64,64,64,64,64,64,64,64,64,64,64,64,64,64,64,64,64,64,64,102,102,102,102,64,64,64,64,64,64,64,64
64,64,64,64,64,64,64,64,64,64,64,64,64,64,64,64,64,64,64,64,64,64,64,64,64,64,64,64,64,64,64,64,64,64,64,64,64,64,64,64,64,64,64,64,64,64,64,64,64,64,64,64,64,64,64,64,64,64,64,64,64,64,64,64,64,64,64,64,64,128,102,102,102,102,102,102,102,132,64,64,64,64,64,64,64,64,64,64,64,64,64,64,128,102,102,102,102,102,102,102,102,131,64,64,64,64,64,64,64,64,128,102,102,102,102,102,102,102,102,102,102,102,102,99,97,102,102,102,102,102,102,102,102,102,102,102,131,132,64,64,64,64,64,64,64,64,64,64,64,64,64,64,64,97,102,102,102,102,102,102,102,102,102,64,64,64,64,64,64,64,64,64,64,64,64,64,64,64,64,64,64,64,64,64,102,102,102,102,102,102,102,102,102,64,64,64,64,64,64,64
64,64,64,64,64,64,64,64,64,64,64,64,64,64,64,64,64,64,64,64,64,64,64,64,64,64,96,97,98,98,99,64,64,64,64,64,64,64,64,64,64,64,64,64,64,64,64,64,64,64,64,64,64,64,64,64,64,64,64,64,64,64,64,64,64,64,64,64,128,102,102,102,102,102,102,102,102,102,64,64,64,64,64,64,64,64,64,64,64,64,64,128,102,102,102,102,102,102,102,102,102,102,131,64,64,64,64,64,64,128,102,102,102,102,102,102,102,102,102,102,102,102,102,102,102,102,102,102,102,102,102,102,102,102,102,102,102,102,132,64,64,64,64,64,64,64,64,64,64,64,64,64,97,102,102,102,102,102,102,102,102,102,102,102,64,64,64,64,64,64,64,64,64,64,64,64,64,64,64,64,102,102,102,102,102,102,102,102,102,102,102,102,102,102,64,64,64,64,64,64
64,64,64,64,64,64,128,98,99,64,64,64,64,96,97,98,99,100,64,64,64,64,64,64,64,96,128,129,102,102,102,99,64,100,64,64,64,64,64,64,64,64,64,64,64,96,97,98,98,98,98,98,98,98,98,99,64,64,64,64,64,64,64,64,64,64,64,128,102,102,102,102,102,102,102,102,102,102,132,64,64,64,64,64,64,64,64,64,64,97,102,102,102,102,102,102,102,102,102,102,102,102,102,131,64,64,64,64,128,102,102,102,102,102,102,102,102,102,102,102,102,102,102,102,102,102,102,102,102,102,102,102,102,102,102,102,102,102,102,132,64,64,64,64,64,64,64,64,97,98,98,98,102,102,102,102,102,102,102,102,102,102,102,102,102,64,64,64,64,64,64,64,64,64,64,64,64,64,102,102,102,102,102,102,102,102,102,102,102,102,102,102,102,102,102,64,64,64,64,64
64,64,64,96,96,128,129,130,131,64,64,96,96,97,129,102,131,99,100,64,64,64,64,64,96,128,129,129,102,102,102,131,131,99,100,64,64,64,64,64,64,64,64,64,64,128,129,102,102,102,102,102,102,102,102,102,99,64,64,64,64,64,64,64,64,64,128,102,102,102,102,102,102,102,102,102,102,102,102,132,64,64,64,64,64,64,64,64,128,102,102,102,102,102,102,102,102,102,102,102,102,102,102,102,131,64,64,128,102,102,102,102,102,102,102,102,102,102,102,102,102,102,102,102,102,102,102,102,102,102,102,102,102,102,102,102,102,102,102,102,132,64,64,64,64,64,64,128,102,102,102,102,102,102,102,102,102,102,102,102,102,102,102,102,102,102,102,64,64,64,64,64,64,64,64,64,102,102,102,102,102,102,102,102,102,102,102,102,102,102,102,102,102,102,102,102,102,64,64,64
64,64,64,96,128,129,102,102,102,131,132,96,97,129,102,102,102,131,99,100,64,64,64,96,128,129,102,102,102,102,102,102,102,131,99,100,64,64,64,64,64,64,64,64,128,129,129,102,102,102,102,102,102,102,102,102,131,99,64,64,64,64,64,64,64,128,102,102,102,102,102,102,102,102,102,102,102,102,102,102,132,64,64,64,64,64,64,128,102,102,102,102,102,102,102,102,102,102,102,102,102,102,102,102,102,131,128,102,102,102,102,102,102,102,102,102,102,102,102,102,102,102,102,102,102,102,102,102,102,102,102,102,102,102,102,102,102,102,102,102,102,132,64,64,64,64,128,102,102,102,102,102,102,102,102,102,102,102,102,102,102,102,102,102,102,102,102,102,64,64,64,64,64,64,102,102,102,102,102,102,102,102,102,102,102,102,102,102,102,102,102,102,102,102,102,102,102,102,102,64
64,96,96,128,129,102,102,102,102,102,102,132,129,129,102,102,102,102,131,132,64,100,96,128,129,102,102,102,102,102,102,102,102,102,131,132,64,64,64,64,64,64,64,128,129,102,102,102,102,102,102,102,102,102,102,102,102,102,132,64,64,64,64,64,128,102,102,102,102,102,102,102,102,102,102,102,102,102,102,102,102,102,132,64,64,64,128,102,102,102,102,102,102,102,102,102,102,102,102,102,102,102,102,102,102,102,102,102,102,102,102,102,102,102,102,102,102,102,102,102,102,102,102,102,102,102,102,102,102,102,102,102,102,102,102,102,102,102,102,102,102,102,132,64,64,128,102,102,102,102,102,102,102,102,102,102,102,102,102,102,102,102,102,102,102,102,102,102,102,102,102,102,102,102,102,102,102,102,102,102,102,102,102,102,102,102,102,102,102,102,102,102,102,102,102,102,102,102,102,102
64,128,102,102,102,102,102,102,102,102,102,130,130,102,102,102,102,102,102,102,131,132,128,129,102,102,102,102,102,102,102,102,102,102,102,102,102,102,102,64,128,129,102,102,102,102,102,102,102,102,102,102,102,102,102,102,102,102,102,132,64,64,64,128,102,102,102,102,102,102,102,102,102,102,102,102,102,102,102,102,102,102,102,132,64,128,102,102,102,102,102,102,102,102,102,102,102,102,102,102,102,102,102,102,102,102,102,102,102,102,102,102,102,102,102,102,102,102,102,102,102,102,102,102,102,102,102,102,102,102,102,102,102,102,102,102,102,102,102,102,102,102,102,132,128,102,102,102,102,102,102,102,102,102,102,102,102,102,102,102,102,102,102,102,102,102,102,102,102,102,102,102,102,102,102,102,102,102,102,102,102,102,102,102,102,102,102,102,102,102,102,102,102,102,102,102,102,102,102,102
128,129,102,102,102,102,102,102,102,102,102,102,102,102,102,102,102,102,102,102,102,102,102,102,102,102,102,102,102,102,102,102,102,102,102,102,102,102,102,102,102,102,102,102,102,102,102,102,102,102,102,102,102,102,102,102,102,102,102,102,102,102,102,102,102,102,102,102,102,102,102,102,102,102,102,102,102,102,102,102,102,102,102,102,102,102,102,102,102,102,102,102,102,102,102,102,102,102,102,102,102,102,102,102,102,102,102,102,102,102,102,102,102,102,102,102,102,102,102,102,102,102,102,102,102,102,102,102,102,102,102,102,102,102,102,102,102,102,102,102,102,102,102,102,102,102,102,102,102,102,102,102,102,102,102,102,102,102,102,102,102,102,102,102,102,102,102,102,102,102,102,102,102,102,102,102,102,102,102,102,102,102,102,102,102,102,102,102,102,102,102,102,102,102,102,102,102,102,102,102
80,80,80,80,80,113,114,80,80,80,80,80,80,80,113,114,80,80,80,80,80,80,80,80,80,80,80,80,80,80,80,80,80,80,113,114,80,80,80,80,80,80,80,80,80,80,80,80,80,80,80,80,80,80,80,80,80,113,114,80,80,80,80,80,80,80,80,80,80,109,110,80,80,80,80,80,80,80,80,80,80,80,80,80,80,80,80,80,80,80,80,80,80,80,80,80,80,80,80,80,80,80,80,80,80,80,80,80,80,80,80,80,80,80,80,80,80,80,80,80,80,80,80,80,80,80,80,80,80,80,80,80,80,80,80,80,80,80,80,80,80,80,80,80,80,80,80,80,80,80,80,80,80,80,80,80,80,80,80,80,80,80,80,80,80,80,80,80,80,80,80,80,80,80,80,80,80,80,80,80,80,80,80,80,80,80,80,80,80,80,80,80,80,80,80,80,80,80,80,80
80,80,80,80,80,80,80,80,80,80,80,80,80,80,80,80,80,80,80,80,80,80,113,114,80,80,80,80,80,80,71,72,80,80,80,80,80,80,80,73,74,75,80,80,80,113,114,80,80,80,80,80,80,80,80,80,80,80,80,80,80,80,80,80,80,80,80,80,80,80,80,80,80,80,80,113,114,80,80,80,80,80,113,114,80,80,80,80,80,80,80,80,80,80,80,80,80,80,80,113,114,80,80,80,80,80,113,114,80,80,80,80,80,109,110,80,80,80,80,80,80,80,80,80,80,113,114,80,80,80,109,110,80,80,80,105,106,107,80,113,114,80,80,80,80,80,73,74,75,80,80,80,80,80,80,80,80,80,80,113,114,80,80,80,80,80,80,80,113,114,80,80,80,80,80,80,80,80,109,110,80,80,80,113,114,80,80,80,80,80,80,80,80,113,114,80,80,80,80,80
80,80,80,73,74,75,80,80,80,80,80,80,80,80,80,80,80,80,80,80,80,80,80,80,80,80,80,80,80,80,103,104,80,80,80,80,80,80,80,80,80,80,80,80,80,80,80,80,80,80,80,80,80,80,80,80,80,80,80,80,80,80,80,80,80,80,80,80,80,80,80,80,80,80,80,80,80,80,80,80,80,80,80,80,80,80,80,80,80,80,80,80,109,110,80,80,80,80,105,106,107,80,80,80,80,80,80,80,73,74,75,80,80,80,80,80,80,80,80,80,80,73,74,75,80,80,80,80,80,80,80,80,80,80,80,80,80,80,80,80,80,80,80,80,80,80,80,80,80,80,80,80,80,80,80,80,80,80,80,80,80,80,80,80,80,80,80,80,80,80,80,80,80,80,80,80,80,80,80,80,80,80,80,80,80,80,80,80,80,80,80,80,80,80,80,80,80,80,105,106
80,80,80,80,80,80,80,80,80,80,80,80,80,80,80,73,74,75,80,80,105,106,107,80,80,80,80,80,80,80,135,136,80,80,80,80,80,80,166,166,80,80,80,80,80,80,80,80,80,80,80,80,80,80,80,80,80,80,80,80,80,80,80,80,80,80,80,80,80,80,80,80,80,80,80,80,80,80,80,80,80,80,80,80,80,80,80,80,80,80,80,80,80,80,80,80,80,80,80,80,80,80,80,80,80,80,80,80,80,80,80,80,80,80,80,80,80,80,80,80,80,80,80,80,80,80,80,80,80,80,80,80,80,80,80,80,80,80,80,80,80,80,80,80,80,80,80,80,80,80,80,80,80,80,80,80,80,80,80,80,80,80,109,110,80,80,80,80,80,80,80,80,80,73,74,75,80,80,80,80,80,80,80,80,80,80,80,80,80,73,74,75,80,80,80,80,80,80,80,80
80,80,80,80,80,80,80,80,80,174,174,80,80,80,80,80,80,80,80,80,80,80,80,80,80,80,80,80,80,80,80,80,80,80,80,80,80,80,80,80,166,166,80,80,80,80,80,80,80,80,80,80,80,80,80,80,80,80,80,80,80,80,80,80,80,80,80,80,80,80,80,80,80,80,80,80,80,80,80,80,80,80,80,80,80,80,80,80,80,80,80,80,80,80,80,80,80,80,80,80,80,80,80,80,80,80,80,80,80,80,80,80,80,80,80,80,80,80,80,80,80,80,80,80,80,80,80,80,80,80,80,80,80,80,80,80,80,80,80,80,80,80,80,80,80,80,80,80,80,80,80,80,80,80,80,80,80,80,80,80,80,80,80,80,80,80,80,80,80,80,80,80,80,80,80,80,80,80,80,80,80,80,80,80,80,80,80,80,80,80,80,80,80,80,80,80,80,80,80,80
80,80,80,80,80,80,174,174,80,80,80,80,80,80,80,80,73,74,75,80,80,80,80,80,80,80,80,80,80,80,80,80,80,80,80,80,80,80,80,80,80,80,166,166,167,166,166,80,80,80,227,228,227,80,80,80,227,227,227,227,80,80,80,80,80,109,110,80,80,80,80,80,80,73,74,75,80,80,80,80,80,80,80,80,80,80,80,80,80,80,80,80,80,80,80,80,80,80,80,80,80,80,80,80,80,80,80,80,80,80,80,80,80,80,80,80,80,80,80,80,80,80,80,80,80,80,80,80,80,80,80,80,80,80,80,80,80,80,80,80,80,80,80,80,80,80,80,80,80,80,80,80,80,80,80,80,80,80,80,80,80,80,80,80,80,80,80,80,80,80,80,80,80,80,80,80,80,80,80,80,80,80,80,80,80,80,80,80,80,80,80,80,80,80,80,80,80,80,80,80
174,174,174,174,80,80,80,80,80,80,80,80,80,80,80,80,80,80,80,80,80,80,80,80,80,80,80,80,80,80,73,74,75,80,80,80,80,80,80,80,80,80,80,80,80,80,80,80,80,227,228,227,228,80,80,80,227,227,228,227,228,80,80,80,80,80,80,80,80,80,80,80,80,80,80,80,80,80,80,80,80,80,80,80,80,80,80,80,80,80,80,80,80,73,74,75,80,80,80,80,80,80,80,80,80,80,80,80,80,80,80,80,80,80,80,80,80,80,80,80,80,80,80,80,80,80,80,80,80,80,80,80,80,80,80,73,73,74,75,80,80,80,80,80,80,80,80,80,80,80,80,80,80,80,80,80,80,80,80,80,80,73,74,75,80,80,80,80,80,80,80,80,80,80,80,80,80,80,80,80,80,80,80,80,80,80,80,80,80,80,80,80,80,80,80,80,80,80,80,80
80,80,80,80,80,80,80,80,80,80,80,80,80,80,80,80,80,80,80,80,80,80,80,80,80,80,80,80,80,80,80,80,80,80,80,80,80,80,80,80,80,80,80,80,80,80,80,80,227,228,227,228,227,80,80,80,227,227,227,228,227,228,80,80,80,80,80,80,80,80,170,170,170,170,171,172,80,80,80,170,170,170,171,172,80,80,80,80,80,80,80,80,80,80,80,80,80,80,80,80,80,80,80,80,80,105,106,107,80,80,80,80,80,80,80,80,73,74,75,80,80,80,80,80,80,80,80,80,80,105,106,107,80,80,80,80,80,80,80,80,80,80,80,80,80,80,80,80,80,80,80,80,80,80,80,80,80,80,80,80,80,80,80,80,80,80,80,80,80,80,80,80,80,80,80,80,80,105,106,107,80,80,80,80,80,80,80,80,80,80,80,80,80,80,80,80,80,80,73,74
80,80,80,80,80,174,174,80,80,80,80,80,80,80,80,80,80,80,80,80,80,80,80,80,80,80,80,80,80,80,80,80,80,80,80,80,80,80,80,80,80,80,80,80,80,80,80,227,228,227,227,228,227,80,80,80,227,227,227,228,227,228,227,80,80,80,80,80,80,80,80,80,80,80,80,170,170,170,171,172,80,80,80,80,80,80,80,80,80,80,80,80,80,80,80,80,80,80,80,80,80,80,80,80,80,80,80,80,80,80,80,80,80,80,80,80,80,80,80,80,80,80,80,80,80,80,80,80,80,80,80,80,80,80,80,80,80,80,80,80,80,80,80,80,80,80,80,80,80,80,80,80,80,80,80,80,80,80,80,80,80,80,80,80,80,80,80,80,80,80,80,80,80,80,80,80,80,80,80,80,80,80,80,80,80,80,80,80,80,80,80,80,80,80,80,80,80,80,80,80
80,80,80,80,80,80,80,80,80,168,168,80,80,80,80,80,80,80,80,80,80,80,80,80,80,80,80,80,80,80,80,80,80,80,80,80,80,80,80,80,80,80,80,80,80,80,227,228,227,228,227,227,227,80,80,80,227,227,228,227,228,227,228,228,80,80,80,80,80,80,80,80,80,80,80,80,80,80,80,80,80,80,80,80,80,227,228,80,80,80,80,80,80,80,80,80,80,80,80,80,80,80,80,80,80,80,80,80,80,80,80,80,80,80,80,80,80,80,80,80,80,80,80,227,228,80,80,80,80,80,80,80,80,80,80,80,80,80,80,80,80,80,80,80,80,80,80,80,80,80,80,80,80,80,80,80,80,80,80,80,80,80,80,80,80,80,80,80,80,80,80,80,80,80,80,80,80,80,80,80,80,227,228,80,80,80,80,80,80,80,80,80,80,80,80,80,80,80,80,80
160,161,162,163,164,165,160,160,160,160,160,160,161,80,80,161,160,160,161,162,160,165,165,165,160,161,160,161,160,160,160,160,161,160,161,161,162,163,164,165,161,162,163,164,160,161,162,163,164,165,160,160,160,80,80,80,160,161,162,160,161,162,163,164,160,161,162,163,164,160,161,162,163,164,160,161,162,163,164,160,161,162,163,164,160,161,162,160,161,162,80,80,160,161,80,80,164,160,80,80,163,164,80,80,161,162,163,164,160,161,162,163,160,161,162,163,164,165,160,161,162,163,160,161,162,163,160,161,162,163,164,160,161,162,160,161,162,163,160,161,162,163,164,160,160,161,162,160,161,162,163,160,161,162,163,160,161,162,163,164,160,161,162,163,164,160,161,162,163,160,161,162,163,164,160,161,162,163,160,161,162,160,161,162,163,164,165,160,161,162,163,160,161,162,163,160,161,162,160,160
